=login.html
login=LoginServlet
loginE=login.jsp
register=SignUpServlet
signOut=SignOutServlet
home=home.jsp
loadSubject=LoadSubjectServlet
loadQuestion=LoadQuestionServlet
loadAnswer=LoadAnswerServlet
quiz=quiz.jsp
submit=SubmitServlet
result=result.jsp
countPageForHistory=CountPageForHistoryServlet
showHistory=ShowHistoryServlet
countPageWithFilter=CountPageWithFilterServlet
showHistoryWithFilter=ShowHistoryWithFilterServlet
history=history.jsp
detailExam=DetailExamServlet
admin_home=admin_home.jsp
AddSubject=AddSubjectServlet
deleteSubject=DeleteSubjectServlet
restoreSubject=RestoreSubjectServlet
question=question.jsp
countNumOfPage=CountNumOfPageServlet
loadQuestionByAdmin=LoadQuestionByAdminServlet
deleteQuestion=DeleteQuestionServlet
restoreQuestion=RestoreQuestionServlet
searchQuestion=SearchQuestionServlet
loadQuestionWithSearch=LoadQuestionWithSearchServlet
AddQuestion=AddQuestionServlet
loadDetailQuestion=LoadDetailQuestionServlet
saveUpdate=SaveUpdateServlet